11111111111
10000000011
10P00000011
1000C00E011
10000000011
11111111111
