1111111111111
100000001E001
10P000C011001
1000011100001
1000000000C01
1000C01000001
1000001000011
1111111111111
