1111111111111111111111111111111111111111111111111
1000000000000100000000000000000000000010000000001
1000000011111110000000000000000000000110000000001
1000000000111110000000000000000111111000000000001
1000000000000110000000000000000000011111111111111
1000000000000010000000000000000000000000000000001
10111111000000000000000P0000000000000000000000001
1000000000000000000000000001000000000000000000001
1000000000000000000000000000000000001000000000001
1000000000C00000000000000000000001111111000000001
1000000000000000000000000000000000001000000000001
1000000000000000001111110000010000001000000000001
1000000000001111111000011000010000001000000000001
1000000000000011110011011100010000001000000000011
1000000000000001E00010000000010000000000000000111
1111111111111111111111111111111111111111111111111
