1111111111
1CCCCCCCC1
1CPCCCCCC1
1CCCCCCEC1
1CCCCCCCC1
1111111111
