1111111111
1000NNNNN1
10P0NNNNN1
1000C00EN1
10NNNNNNN1
1111111111
