1111111111
1000000001
10P0000N01
1000C00E01
1000000001
1111111111
