1111111111111
1NN000001E0N1
1NP000C011001
1000011100001
100000C00NC01
10N0C01000001
100000100N011
1111111111111
