1111111111
1000000001
10P000NNN1
1000CN0E01
10000N0001
1111111111
