1111101111
1000000001
10P0000000
1000C00E01
1000000001
1111111111
