1111111111
1000000001
10P0000101
1000C01E11
1000000101
1111111111
