1111111111
1000000001
10P0001111
1000C01E01
1000001001
1111111111
