1111111111
1000000001
10P000CCC1
1000C0CEC1
100000CCC1
1111111111
