11111111111111111111111111
1C000000000000000000000001
10000000000000000C00000001
10P0C00E000000000000000001
10000000000000000000000001
10000000000000000C00000001
1000000000C0000000000000C1
11111111111111111111111111
