1111111111
1000000001
10P000NNN1
1000C0NE01
100000N001
1111111111
